#########
#SM#.P###
##.#T####
##.#.MT##
##.#T#...
##.#.#..E
.....####
##..M####
##.######
