S##M.M#M#
M##MMMTT#
MMM.MMMMM
MM.MMMMMM
P..MM#M##
.##M#MMMM
MM#####M#
#.##.MMME
.T##TPMM#
