S.M#MMM.M
MMM#MM.MM
MM.#MTM#M
#M..TMMMM
MM.MMMMM#
P.M.M.MMM
#MTTMM.M#
#TMTTTMM#
###.#MMME
